##...###
..##.#.####
.##..#.#..#
##........#
#..#@#.#..#
###...##..#
..#..#....#
.##.##.#.##
.#...#..##
#.#.#..##
.####....##